13 11
01111111111
10001000001
10111011101
10100010001
10101110111
10000010001
11111111101
10000000001
10111111101
10000010101
11111010101
10000010001
11111111110